1111111111111111111111111111111111
10100000C0011C1C00000C0000000001C1
101001010001EC10101001000000010001
1C00010010101010001001000000010101
101P00000C0000000000000000000000C1
1111111111111111111111111111111111
